11111111
10000011
11111111
11CC1111
1P101111
11111111
