11111111
10000011
11111111
11CC1E11
11101111
11111111
