11111111
10000011
11111111
11CC1E11
1P101111
1111111