11111111
10010C11
11011011
110C1E11
1P000011
11111111
