11111111
10000511
11111111
11CC1E11
1P101111
11111111
