1111111111
1000C000C1
1101001001
11C1E01001
1P010010C1
1111111111